*******
*S    *
*  ** *
** *G *
*  ** *
**    *
*******
